////+///*
+///M///*
+///M///*
////M///*
////////*
////////*
////////*
////////*
*********