*////#///
*////@///
*////#///
*M///#///
*#//+#///