*******#////////
**/////#////////
**/////#////////
**/M//////////++
**/////#////////
**//M//#////////
*******#////////
