RX*****#////////
RX/////#////////
RX/////#////////
R*/M//////////++
**/////#////////
**//M//#////////
****U**#////////
