----------------------
----------------------
----------------------
VVVVVVVVVVVVVVVVVVVVVV
////////////////////**
////////////////////**
***/////////////////**
*M*/RRLLRRLLRRLLRRLL+*
***/////////////////**
////////////////////**
////////////////////**
VVVVVVVVVVVVVVVVVVVVVV
----------------------
----------------------