////////////+////////////
//#/////////#/////////#//
//#///////////////////#//
//#*********M*********#//
**#*#***************#*#**
*************************
