////////////+////////////
//#/////////#/////////#//
//#///////////////////#//
//#*******R*M*********#//
**#*#***************#*#L*
***********R********U*U**
