#################
##RX@////////**##
#############**##
#XXXXXXXXXXX#//##
#XXXXXXXXXXX#//##
#############//##
#**////////////##
#**///////////***
#//////M/////**@#
#/###############
#/#XXXXXXXXXXXXX#
#/#XXXXXXXXXXXXX#
#+###############