#################
##RX@////////**##
#############RR##
#XXXXXXXXXXX#//##
#XXXXXXXXXXX#//##
#############//##
#**////////////##
#**///////////RL@
#//////M/////**@#
#/###############
#/#XXXXXXXXXXXXX#
#/#XXXXXXXXXXXXX#
#+###############