-------------*-
*****////////**
----*/////M///-
----*////M////-
----*///M/////-
----*////VVV/+-
----*////VVV/+-
