#####################
//////////#//////////
//////////#///M//M///
**////C//+#///M//M///
**///M///+#/M//////M/
//////////#//MMMMMM//
//////////#//////////
#####################