////*////
////M////
////+////
*M/+#+/M*
////+////
////M////
////*////
