----------------*********
----------------*#*******
----------------*********
----------------*********
----------------******V**
**////////M/////*********
**//////////////***///+#M
----------------***/////+