----------------***RR***@
----------------*#*******
----------------@*******@
----------------*********
----------------******V*D
*R////////M/////*********
R*//////////////***///+#M
----------------***/////+